見積書	みつもりしょ	估價單
項目	こうも	項目
合計	ごうけい
平均値	へいきんち
連続	れんぞく
過去	かこ
数値	すうち
	がピーク	高峰
比較	ひかく
習慣	しゅうかん
分析	ぶんせき
携わった	たずさわった	涉及的問題
端末	たんまつ
普及	ふきゅう
程度	ていど
奪て	うばて
容疑者	ようぎしゃ	嫌疑犯
原因	げんいん
被害	ひがい
団体	だんたい
集める	あつめる
浮き	うき	漂浮
長径	ちょうけい	直徑
囲む	かこんむ	包圍
機械	きかい
アライグマ	浣熊
輸入	ゆにゅう
捨てる	すてる	丟掉
畑	はたけ	場
農地	のうち	農地
天井	てんじょう	天花板
きた	北
高知	こうち
教会	きょうかい
聖母	せいぼ
像	ぞう
塗る	ぬる	抹/擦/抹黑
苫	とま	草蓆
動く	うごく	變化/移動/動搖
政府	せいふ
家庭	かてい
ほとんど	多數
拠点	きょてん	據點
移籍	いせき	遷移
補償	ほしょう	
投手	とうしゅ
入団	にゅうだん
臨む	のぞむ
貢献	こうけん
抱負	ほうふう	心願
語り	かたり	談
通算	つうさん
獲得	かくとく
驚いた	おどろいた
先発	せんぱつ
補強	ほきょ
渡辺久信	わたなべひさのぶ
菊池雄星	きくちゆうせい
大車輪	だいしゃりん	拼命
活躍	かつやく
経験	けいけん
期待	きたい
お寄せ	およせ
見通し	みとおし	預測、展望、前景
対処	たいしょ	處理
確立	かくりつ	確立、建立
目途	めど	目標
委ねる	ゆだねる	委託
指摘	してき	指出
解析	かいせき	
手法	しゅほう	手法、模式、方法
見直す	みなおす	重新認識
見る	みる	估計、看、調查
提出する	ていしゅつする
強要	きょうよう	強逼、勒所
見舞い	みまい	慰問、看望
ハイジャック		劫機
突っ込み つっこんみ 深入
テロ		恐怖主義者
亡く	なく
代表	だいひょう
遺体	いたい
記念碑	きねんひ
セーリング		帆船
開会式	かいかいしき
イルカ		海豚
謝る	あやまる	道歉、受不了
誤る	あやまる	犯錯、弄錯
行い	おこない	進行
ヨット		遊艇
ツイッター		嘰嘰喳喳
乱暴	らんぼう	粗暴
つぃて		關於
情報	じょうほう	
特徴	とくちょう
配り	くばり	分發派送
財団	ざいだん
大会	たいかい
手伝い		幫忙
ボランティア		志願者
割合	わりあい	百分比
結果	けっか		
流石	さすが	不愧是、正如所料
情弱	じょうじゃく	情報弱者(諷刺)
ガニに		給小子
奴が		那傢伙
賭ける	かける	
雰囲気	ふんいき	氣氛感覺
＝狀態==
気持ち	きもち　	心情
機嫌	きげん	心理狀態/短暫的情緒
気分	きぶん	肉體狀態
むしろ		反倒、寧可
糾弾	きゅうだん	譴責痛斥
非難	ひなん	批評
彷彿	ほうふつ	聯想
癖		くせ		癖好
とりあえず		暫且、姑且
勿体ない	もったいない	可惜
限り	かぎり	界線、到...為止
心強い	こころつよい	安心
メンタル			心理
指導	しどう	
枠		わく
正直	しょうじき	說實話，正當
比べて	くらべて	比較、競爭
しっかり	充裕
水素	すいそ	氫氣
エネルギー		能源
視界	しかい	視野
抜け	ぬけ	遺漏疏忽
外れ	はずれ	未如所願
崖っぷち	がけっぷち	懸崖邊
ぶり		經過..之後
本拠地	ほんきょち	主場、根據地
二桁	ふたけた	二位數
挙げる	あげる	提出、抬高、宣傳、舉行
サード		三壘
仮	かり	暫時的、假貨
真っ当だ	まっとうだ	認真、正經
支え	ささえ	擔心、空虛
肘	ひじ
リハビリ		康復
繰り	くり	權宜之計、湊合
仮想通貨	かそうつうか	虛擬貨幣
なくなる		不見
亡くなる	なくなる	死亡
コスモス	波斯菊
紫	むらさき
腕	うで
治す	なおす	治癒
渡す	わたす	給
ヒラメ		比目魚
増え	ふえ
訪ねる	たずねる	訪問
通る	とおる	通過、貫穿
冠	かんむり	帽子
アザラシ		海豹
雌	めす
=22=
海峡	かいきょう
発生	はっせい
死亡	しぼう
よって		隨著
伴う	ともなう	跟隨
火山	かざん	
活動	かつどう
再び	ふたたび
防災	ぼうさい
住民	じゅみん
警戒	けいかい
現地	げんち
行方不明	ゆくえふめい	失蹤
詳しい	くわしい
把握	はあく
地域	ちいき
犠牲者	ぎせいしゃ
国軍	こくぐん
兵士	へいし
倒壊	とうかい
周辺	しゅうへん
捜査	そうさ
重機	じゅうき
不足	ふそく
手作業	てさぎょう
行う	おこなう	執行，做
一方	いっぽう	一方面
噴火	ふんか
地滑り	じすべり	山崩
依然	いぜん
活発	かっぱつ	熱烈
大手	おおて	狂妄、無所忌憚、前門正門、大企業、龍頭
トランスジェンダー		跨性別
=25==
弁護士	べんごし	律師
通じて	つうじて	一般來說、總的來說
報道機関	ほうどうきかん	報導看物
手記	しゅき
ハラスメント	騷擾
人件費	じんけんひ	人工費、用人經費
健康	けんこう
==25==
冬型	ふゆがた
気圧	きあつ
配置	はいち
中心	ちゅうしん
伴って	ともなって
非常	ひじょ
大荒れ	おおあれ	暴風雨
まとまる		達成、集中、歸納起來
暴風	ぼうふう
警戒	けいかい
交通	こうつう
十分	じゅうぶん
込み	こみ	包括在內
見込み	みこみ	預估預計
東北	とうほく
北陸	ほくりく	
猛吹雪　もうふぶき
電線	でんせん
樹木	じゅもく
雪崩	なだれ
時期	じき
重なる	かさなる 重疊
影響	えいきょう
=1/2=
頼れる	たよれる	依賴、依靠、可靠
暮らし	くらし	　生活、過日子、生活費
下回る	したまわる	水準以下
貧困	ひんこん	貧困
除く	のぞく	扣除、除掉
印刷	いんさつ	印刷
正規	せいき	正規
雇用	こよう	雇用
光熱費	こうねつひ	電費、煤氣費
心寄せ	こころよせ	有好感、愛慕
感染	かんせん
示し	しめし	警戒 起示
強化	きょうか　增強鞏固
浜辺	はまべ	海岸
コレラ	霍亂
ウイルス 病毒
陽性反応	ようせいはんのう
関する	かんする	與~有關
基づく	もとづく	基於、根據
繰り返し	くりかえし	再三
恣意的	しいてき	隨意任性
拘束する	こうそくする 約束、限制
渡航する	とこうする	出國、去海外
